NO srcs/textures/hitler.xpm

       EA                srcs/textures/wall4.xpm

WE srcs/textures/hitler.xpm

SO srcs/textures/wall4.xpm

C 128,128,128


F 255,255,255


                         111111111
                        10000000001
                        10000000001
                         10S000001
11111    111111111111111111010001
10001    110000000000000000100001
100111111011111110001111111000001
10001    100000000000000001111111
11011    11111111111001101                           1111111
10001111111000000000000001                           10000001
10001000011011111111111111111111111111111           1000000001
1000000001101               1000000000001         1100000000001
1000100001101               100000000000011111111110000000000001
100011001110111111          100000000000000000000000000000000001
100011000000000001          100000000000111111111110000000000001
100011000000000001          1000000000001          100000000001
10001100000000000111111111111000000000001           1000000001
10001100000000000000000000000000011111111            10000001
1000110000000000011111111111111011                    111111
100001000000000001           10001
100000000000000001           10001
100001000000000001           10001
100011000000000001           10001
100011000000000001          10001
100011000000000001         10001
100011000000000001        10001
100011111111111111       10001
10001            11111  10001
1001          11100000111011
101         110000000000001
101        10000000010000001
101       1000000000000000001
101111111100000000000000000001
100000000000000000000000000001
101111100011111111111000000001
100000000000100000000000000001
100011111100100000000000000001
100000000000100000000000000001
100000000000100011111111111001
100111111110100000000100000001
100000000000100000000100000001
100000000000010000000100000001
100000000100010000100000000001
100000000100010000100000000001
100111000100010000100000000001
100000000100010000111111000001
100000000100010000100000000001
100000000100001000100000000001
100000000000001000000000000001
100000001000001000000000000001
101101111000001000000000000001
100000001000001000100000000001
100000001000001000100000000001
100000001000000000100000000001
100000001000000000100000000001
100000000001000000100000000001
100000000001000000100000000001
100000000001000000000000000001
100000000001000000000000000001
100000000001000100000000000001
100000000001000100000000000001
100000000000000100000000000001
100000000000000100000000000001
100000000000000100000000000001
100000000000000100000000000001
100000000000000000000000000001
100000000000000000000000000001
100000000000000000000000000001
111111111100000000000000000001
          1000000000000000001
           10000000000000001
            110000000000011
              11100000111
                 11111
