NO srcs/textures/west.xpm

EA srcs/textures/west.xpm

WE srcs/textures/west.xpm

SO srcs/textures/west.xpm

             C        128    ,     128           ,     128


F 218, 247, 255
 
11111111111111111111111111111111111111111111111111111111111111111111111111111111
 10000000000000010000000000000000000000001000000000000000000100000000000000000001
 10000000000000010000000000000000000000001000000000000000000100000000000000000001
 10000000000000010000000000000000000000001000000000000000000100000000000000000001
 1000000000N000010000000000000000000000001000000000000000000100000000000000000001
 10000000000000010000000000000000000000001000000000000000000100000000000000000001
 10000000000000010000000000000000000000001000000000000000000100000000000000000001
 10000000000000010000000000000000000000001000000000000000000100000000000000000001
 10000000000000010000000000000000000000001000000000000000000100000000000000000001
 10000000000000000000000000000000000000001000000000000000000100000000000000000001
 10000000000000010000000000000000000000001000000000000000000100000000000000000001
 11111111111111111111111111111111111111111111111111111111111111111111111111111111  
 11111111111111111111111111111111110111111111111111111111111111111111111111111111
 11111111111111111111111111111110111111111111111111111011111111111111111111100111
 10000000000000010000000000000000000000001000000000000000000100000000000000000001
 10000000000000010000000000000000000000001000000000000000000100000000000000000001
 10000000000000010000000000000000000000001000000000000000000100000000000000000001
 10000000000000010000000000000000000000001000000000000000000100000000000000000001
 10000000000000010000000000000000000000001000000000000000000100000000000000000001
 10000000000000010000000000000000000000001000000000000000000000000000000000000001
 10000000000000010000000000000000000000001000000000000000000000000000000000000001
 10000000000000010000000000000000000000001000000000000000000100000000000000000001
 10000000000000010000000000000000000000001000000000000000000100000000000000000001
 10000000000000010000000000000000000000001000000000000000000100000000000000000001
 10000000000000010000000000000000000000001000000000000000000100000000000000000001
 10000000000000010000000000000000000000001000000000000000000100000000000000000001
 10000000000000010000000000000000000000001000000000000000000100000000000000000001
 10000000000000010000000000000000000000001000000000000000000100000000000000000001
 10000000000000010000000000000000000000001000000000000000000100000000000000000001
 11001111111111111111111111111001111111111111001111111111111111111111111111001111
 10000000000000010000000000000000000000001000000000000000000100000000000000000001
 10000000000000010000000000000000000000000000000000000000000100000000000000000001
 10000000000000010000000000000000000000000000000000000000000100000000000000000001
 10000000000000010000000000000000000000001000000000000000000100000000000000000001
 10000000000000010000000000000000000000001000000000000000000100000000000000000001
 10000000000000010000000000000000000000001000000000000000000100000000000000000001
 10000000000000010000000000000000000000001000000000000000000100000000000000000001
 10000000000000010000000000000000000000001000000000000000000100000000000000000001
 10000000000000010000000000000000000000001000000000000000000100000000000000000001
 10000000000000010000000000000000000000001000000000000000000100000000000000000001
 10000000000000010000000000000000000000001000000000000000000100000000000000000001
 10000000000000010000000000000000000000001000000000000000000100000000000000000001
 10000000000000010000000000000000000000001000000000000000000100000000000000000001
 10000000000000010000000000000000000000001000000000000000000100000000000000000001
 11111111111111111111111111111111111111111111111111111111111111111111111111111111


                  
         

