NO srcs/textures/wall4.xpm

EA srcs/textures/hitler.xpm

WE srcs/textures/wall.xpm

SO srcs/textures/wall.xpm

C 128,128,128


F 218, 247, 166
 
11111111111111111111111111111111111111111111111111111111111111111111111111111111
1000000000000001000C000000000000000000001000000000000000000100000000000000000001
100000000000000100000000000000000S0000001000000000000000000100000000000000000001
10000000000000010000000000000000000000001000000000000000000100000000000000000001
1000000000000001000C000000000000000000001000000000000000000100000000000000000001
11111111111111111111111111111111111111111111111111111111111111111111111111111111