11111111111111111111
10000000000000000001
10000000000000000001
10001110000000000001
1001P001000000000001
10010000100000000001
10001000010000000001
10000100001000000001
10000010000100000001
10000001000010000001
10000000100001000001
10000000010000100001
10000000001000010001
10000000000100001001
10000000000010001001
10000000000001001001
10000000000000110001
10000000000000000001
10000000000000000001
11111111111111111111