11111111111111111111
10000000000000000001
10000000000000000001
10001110000000000001
10010001000000000001
10010000100000000001
10001000010000000001
10000100001000000001
10000010000100000001
10000001000010000001
10000000100000000001
10000000000000000001
10000000000000000001
10000000000000000001
10000000000000000001
10000000000000000001
10000000000000000001
100000000000000P0001
10000000000000000001
11111111111111111111