NO ./textures/hitler.xpm

       EA                ./textures/wall4.xpm

WE ./textures/hitler.xpm

SO ./textures/wall4.xpm

C 225     ,30    ,    0


F 220,100,0








1111111111111             11111111111111 
11100001110111             1111000000001111
111000001111111 11         110000000001111111
10001000011011111111111111111111000000011111
1000000001111               1000000000011
1000100001                  10000000000111
100011001111111111          1000000000011
100011000000000001          1000000000011
100011000000000001 1        111000000000001
10001100000000000111111111111000000000001
10001100000000000001 10000000000000011111111111111111111111
10001100000000000000110000000000011111111
10001100000000000000000000000000011111111
10001100000000000000000000000000011 
10001100000000000000000000000000011111111
1000110000000000000000000000000011111111
100011000000000000001000000000000011111111
1000110000000000000000000000000111111111
1000110000000000000000000000000011111111
100011000000000000000000000N00000011111111
10001100000000000000000000000000011111111
10001100000000000000000000000000011111111
10001100000000111110000110000000000000011
10001100000000000001000000000000011111111
     
10001100000000000010000000000000011111111
10001100000000000110000000000000011111111
10001100000000001000100000000000011111111
10001100000000000000010000000000011111111
10001100000000000000011000000000011111111
11111111111111111111111111111111111111111


