NO ./textures/hitler.xpm
EA ./textures/wall4.xpm
WE ./textures/hitler.xpm
SO ./textures/wall4.xpm

C  225,30,0
F 220,100,0



11111111111111111111111111111111111111111
10001000011011111111111111111111111111111   
1000000001101               1000000000011
1000100001101               1000000000011    1
100011111110111111          1000000000011
100011000000000001          1000000000011
100011000000000001          1000000000001
10001100000000000111111111111000000000001
10001100000000000000000000000000011111111
10001100000000000000000000000000011111111
10001100000000000000000000000000011111111
10001100000000000000000000000000011
10001100000000000000000000000000011111111        1
100011000000P0000000000000000000011111111
1000110000000000000000000000000001111N111111
1000110000000000000000000000N000111111111
100011000000000000000000000000N0011111111
10001100000000000000000000000000011111111
10001100000000000000000000000000011111111
10001100000000000000000000000000011111111
10001100000000111110000110000000000000011
10001100000000000001000000000000011111111
10001100000000000010000000000000011111111
10001100000000000110000000000000011111111
10001100000000001000100000000000011111111
10001100000000000000010000000000011111111
10001100000000000000011000000000011111111
11111111111111111111111111111111111111111

          

		      
		